XXXXXXXXXXXXXXXXXXXXXXXXXXXXXXX
X             X           X   X
X XXXXXXX XXX X X XXXXXXX XXX X
X     X   X   XOX   X   X X   X
XXXXXXX XXX XXXXXXX X X X X X X
X       X   X       X X X   X X
X XXXXXXX XXX XXXXXXXXX XXXXX X
X X     X     X       X   X   X
X XXX XXXXXXXXX X XXX X X X XXX
X   X         X X X     X X   X
X X XXX XXX X XXX XXXXXXX XXX X
X X   X   X X     X   X   X   X
X XXX XXX X XXXXXXX X XXX X XXX
X   X X X X       X X   X X X X
XXXXX X X XXXXXXX X XXX X X X X
X   X X X   X     X X   X X   X
XXX X X XXX X X XXX X XXX XXX X
X X   X     X X X   X X     X X
X XXXXX XXXXX XXX XXX XXXXX X X
X   X   X   X     X X X   X X X
X X X XXX XXXXXXXXX X X X XXX X
X X   X X           X X X     X
X XXXXX X X XXXXXXXXX X XXXXXXX
X X     X X X       X   X     X
X XXXXX X X X XXXXX XXXXXXXXX X
X     X   X       X   X     X X
XXXXX X XXXXXXXXXXX X X X X X X
X     X X         X X X X X X X
X XXXXXXX XXXXXXX X X XXX X X X
X         X         X     X   X
XXXXXXXXXXXXXXX_XXXXXXXXXXXXXXX
