XXXXXXXXXXXXXXXXXXXXX
X       X          OX
X#XXXXXXXXXXX#X XXXXX
X     # X X # X X X X
XXX#X XXX XXXXX X X#X
X   X       #   #   X
X X#XXXXXXX XXX XXXXX
X X X X X #   X     X
X X X X#X XXXXX   X#X
X X X         X   X X
XXXXXXXXXXXXXXXXXXX_X
