XXXXXXXXXXXXXXXXXXXXXXXXXXXXXXXXXXXXXXXXXXXXXXXXXXXXXXXXXXXXX
X       X         X              OX                         X
XXXXX X X XXXXXXX X XXXXXXXXXXXXXXX XXXXXXXXXXXXXXXXXXXXX XXX
X     X   X X     X     X     X         X       X       X   X
X XXXXXXXXX X XXXXX XXX X XXX X XXXXX XXX XXXXX X XXXXX X X X
X   X       X   X X   X X   X   X   X X   X   X   X X   X X X
X X XXX X XXXXX X XXX X X XXXXXXX X X X XXX X XXXXX X XXXXX X
X X X   X X   X X   X X   X     X X X X X   X   X   X X   X X
X X X XXXXX X X X X X XXXXX XXX X X X X X XXXXX X XXX X X X X
X X X     X X   X X       X X     X X X X X     X   X   X   X
XXX X XXX X XXXXX XXXXXXXXX XXXXXXX XXX X X XXXXXXX XXXXXXX X
X   X X X   X   X     X   X   X   X   X X X     X       X   X
X XXX X XXXXXXX XXX XXX X XXX X X XXX X X XXXXX X XXXXX X XXX
X   X X       X     X   X     X X X   X   X     X     X X X X
XXX X XXX XXX XXXXXXX XXXXXXXXX X X XXX XXX XXXXX XXX XXX X X
X X X     X X       X X         X X   X X X     X X X   X X X
X X XXXXXXX XXXXXXX X XXXXX XXX XXXXX X X XXXXX X X XXX X X X
X   X         X     X     X   X     X X   X     X   X X   X X
XXXXX XXXXXXX X XXXXXXXXX XXXXX XXX X XXXXX XXXXXXX X XXXXX X
X X   X       X   X     X     X   X   X   X X X     X       X
X X XXX X XXXXXXX X XXX X XXX XXXXX XXX X X X X XXXXXXX XXX X
X   X   X X       X X   X   X X   X     X X X         X   X X
XXXXX X XXX XXXXXXX X XXXXX X X X XXXXXXX X X XXXXXXX XXX X X
X     X X   X       X   X X X X X   X     X X X     X   X X X
X XXXXXXX XXXXXXXXX XXX X X X X XXX XXX XXX XXX XXX XXX XXX X
X       X X       X   X X   X     X   X   X     X   X X   X X
X XXXXX X X XXXXX XXX X XXXXXXXXXXXXX XXX XXXXXXX XXX XXX X X
X X   X X   X X   X   X             X   X     X   X     X   X
X XXX X XXXXX X XXX XXXXXXXXXXXXXXX XXX XXXXX X XXX XXX XXX X
X     X             X                   X       X     X     X
XXXXXXXXXXXXXXXXXXXXXXXXXXXXXXX_XXXXXXXXXXXXXXXXXXXXXXXXXXXXX
