XXXXXXXXXXXXXXXXXXXXXXXXXXXXXXXXXXXXXXXXXXXXXXXXXXXXXXXXXXXXXX
XXO             XX      XX          XX                      XX
XXXXXXXXXX  XXXXXX  XX  XX  XX  XXXXXX  XXXXXX  XXXXXXXXXX  XX
XX      XX          XX      XX      XX  XX  XX      XX  XX  XX
XX  XX  XX  XXXXXXXXXX  XXXXXXXXXX  XX  XX  XXXXXX  XX  XX  XX
XX  XX  XX  XX      XX  XX      XX              XX  XX      XX
XX  XX  XXXXXX  XX  XXXXXX  XX  XX  XXXXXXXXXX  XX  XXXXXX  XX
XX  XX  XX      XX          XX  XX  XX      XX  XX      XX  XX
XX  XX  XX  XXXXXXXXXXXXXXXXXX  XXXXXX  XX  XXXXXXXXXX  XX  XX
XX  XX      XX  XX              XX      XX      XX      XX  XX
XX  XXXXXXXXXX  XX  XXXXXXXXXXXXXX  XXXXXXXXXX  XX  XXXXXX  XX
XX      XX  XX      XX                      XX      XX      XX
XXXXXX  XX  XX  XXXXXX  XXXXXXXXXXXXXXXXXX  XXXXXXXXXX  XXXXXX
XX      XX  XX      XX          XX      XX      XX      XX  XX
XX  XXXXXX  XXXXXX  XX  XXXXXXXXXX  XX  XX  XX  XX  XXXXXX  XX
XX      XX          XX  XX      XX  XX  XX  XX  XX          XX
XX  XX  XXXXXX  XXXXXX  XX  XX  XX  XX  XXXXXX  XXXXXXXXXX  XX
XX  XX      XX  XX  XX  XX  XX  XX  XX          XX      XX  XX
XX  XXXXXX  XX  XX  XX  XX  XX  XX  XXXXXX  XXXXXX  XX  XX  XX
XX  XX      XX  XX      XX  XX      XX      XX      XX  XX  XX
XXXXXX  XXXXXX  XXXXXX  XX  XXXXXX  XXXXXXXXXX  XXXXXX  XXXXXX
XX      XX  XX      XX  XX      XX  XX          XX  XX      XX
XX  XXXXXX  XXXXXX  XXXXXX  XX  XX  XX  XXXXXXXXXX  XXXXXXXXXX
XX      XX      XX      XX  XX  XX  XX  XX                  XX
XXXXXX  XX  XXXXXXXXXX  XXXXXX  XX  XX  XXXXXXXXXX  XXXXXX  XX
XX      XX          XX          XX  XX              XX  XX  XX
XX  XXXXXX  XX  XX  XXXXXXXXXX  XXXXXXXXXXXXXXXXXXXXXX  XX  XX
XX      XX  XX  XX      XX      XX              XX          XX
XX  XX  XXXXXX  XXXXXXXXXX  XXXXXX  XXXXXXXXXX  XX  XXXXXXXXXX
XX  XX  XX      XX          XX      XX          XX      XX  XX
XX  XX  XX  XXXXXX  XXXXXXXXXX  XXXXXX  XXXXXXXXXXXXXX  XX  XX
XX  XX  XX          XX      XX  XX      XX              XX  XX
XXXXXX  XX  XXXXXXXXXX  XX  XX  XX  XXXXXX  XXXXXXXXXXXXXX  XX
XX      XX          XX  XX      XX  XX      XX      XX      XX
XX  XXXXXXXXXXXXXX  XX  XXXXXXXXXX  XX  XXXXXX  XX  XXXXXX  XX
XX  XX              XX  XX  XX      XX      XX  XX      XX  XX
XX  XXXXXXXXXXXXXXXXXX  XX  XX  XXXXXXXXXX  XX  XXXXXX  XX  XX
XX  XX      XX          XX  XX  XX          XX  XX  XX  XX  XX
XX  XX  XX  XX  XXXXXXXXXX  XX  XX  XXXXXXXXXX  XX  XX  XX  XX
XX      XX                  XX                  XX          XX
XXXXXXXXXXXXXXXXXXXXXXXXXXXXXX_XXXXXXXXXXXXXXXXXXXXXXXXXXXXXXX
