          XXXXXXXXXXXXXXXXXXXXXXXXXXXXXXXXXXX         H
        XXX       X   X X X X X X           XXX       H
      XXX XXXXX XXXXX XDX XDX X XDX XXXXXXX X XXX     H
    XXX X X             X X       X       X X X XXX   H
  XXX X X XXXXXXX XXXXXDX XXXXX XXXXX XXX XXX X X XXX H
XXX X X       X     X   X   X   X X X   X     X     XXX
X X X XXXXX XXXXXXXDXXXXX XDXXXDX XDXXXXX X XDXXX XXX X
X X X                     X         X     X X   X   X X
X XDXXXXXXX X X XXXXXXXXXXXXXXX XXXXXXXXXXXXXXX X XXX X
XDX   X X   X X               X X X       X       X XDX
X@X XXX XXXDXXXDXDXXXDXXXXXXXXXXX XXXXXXX XXXXXXX X X X
X X   X     X   X X X X X   X X X X     X X   X     X X
X X XDX XXXXXXX X XDX X X XXX X XDX XXX XDXDX X XXXXX X
X   X X     X   X   X     XOX X     X   X   X   X X   X
XXX XDXXX XXX XXXXXXXXX XXX X XXX XXXXXXX XXX XXX XXX X
X   X   D X     X   X X X X     X       X   X X X     X
X XXXXX XXXXX XXXXX X X X X XXXXXXX XXXXX XDXXX XXX XDX
X     X X       X     X   X   X   X   X   X   X   XDX X
XXX X XDXXXDXXX XXXXXDX X XXX XDXDXXX X X XXX X X X X X
X   X X     X   X X   X X X     X   X X X   X X X   X X
X X X XXX XXXXXXX X XXX X XXXXXXX XXXXX XDXXX X XXX X X
XXX X X     X X   X X   XDX       X X   X X       X XXX
  XXX X XXX X X XXX XDXXX XXXXXXX X XXX XXX XXX X XXX H
    XXX X   X     X   X         X       X     X XXX   H
      XXX X X XXXXX XXXXXXXXXXX XXXDX X X XXX XXX     H
        XXX       X   X         X   X X X   XXX       H
          XXXXXXXXXXXXX_XXXXXXXXXXXXXXXXXXXXX         H
