X_XXXXXXXXXXXXXXXXXXX
X   X X X     X X   X
XXXDXDX XXXXX X XXXDX
X   D D     D X     X
X   XXX XXX X XXXXX X
X       D X X X   D X
X @   XDX XXX XDXXX X
X     X X   X   X   X
X XDX XXXXX XXXXX XDX
XOX X     X     X X X
XXXXXXXXXXXXXXXXXXXXX
