X_XXXXXXXXXXXXXXXXXXX
X   X X X     X X   X
XXX#X#X XXXXX X XXX#X
X   # #     # X     X
X   XXX XXX X XXXXX X
X       # X X X   # X
X @   X#X XXX X#XXX X
X     X X   X   X   X
X X#X XXXXX XXXXX X#X
XOX X     X     X X X
XXXXXXXXXXXXXXXXXXXXX
