XXXXXXXXXXXXXXXXXXXXXX
XO      X     X    X@X
X XXXXXDX XXXXXXXXDX X
X     X X X      X X X
XXXXX X X X XXXX   X X
X   X X X X    XXXXX X
X X X X   XXXX X     X
X X   XXXXX    X XXXXX
X XXXXX     XXXX     X
X     X XXX X    XXX X
XXXXXDX   X XDXXXX   X
X     XXX XXX    X XXX
X XXX     X   XX X   X
X X X XXXXX XXXX XXX X
X   X       X    X   X
XXXXXXXXXXXXXXXXXX_XXX
